####################
#O @    X        @O#
#  @             @ #
#####              #
#         ##########
#                  #
#                  #
#                  #
########           #
#O     #         # #
#      #         @ #
#      #           #
#    # O#       #  #
#        #         #
#          @       #
#                  #
#     #         #  #
#                  #
#O                O#
####################